1111111111111
100C000111C01
1P000C000C111
111011100C001
10C01C00100E1
1111111111111