1111111111111
100C000111C01
10000C000E111
1P0011100C001
1111111111111