1111111111111
1E00000000001
1P000C0000111
1000000000001
1000100000011
1111111111111
