1111111111111
100C000110C01
1P000C0000111
100011100C001
10001C00100E1
1111111111111