1111111111111111111
1E00000000000000001
1P000C00000000C0001
100000000X000000001
1000100000000000001
1111111111111111111
